---------------
+   +      +  +
+   +      +  +
+   +   +  +  +
+   +   +  +  +
+       +     +
+       +     +
+ +   +    +  +
+ +   +    +  +
+ +   +    +  +
+ +   +    +  +
---------------    